111111111111111111111111111111111111111111111111111111111111
100000000000000000000000000000000000000000000000000000000001
101010101010101010101010101010101010101010101010101010101101
101000000000000000000000000000000000000000000000000000000101
101010101010101010101010101010101010101010101010101010101101
101000000000000000000000000000000000000000000000000000000101
101010101010101010101010101010101010101010101010101010101101
101000000000000000000000000000000000000000000000000000000101
101010101010101010101010101010101010101010101010101010101101
101000000000000000000000000000000000000000000000000000000101
101010101010101010101010101010101010101010101010101010101101
101000000000000000000000000000000000000000000000000000000101
101010101010101010101010101010101010101010101010101010101101
101000000000000000000000000000000000000000000000000000000101
101010101010101010101010101010101010101010101010101010101101
101000000000000000000000000000000000000000000000000000000101
101010101010101010101010101010101010101010101010101010101101
101000000000000000000000000000000000000000000000000000000101
101010101010101010101010101010101010101010101010101010101101
101000000000000000000000000000000000000000000000000000000101
101010101010101010101010101010101010101010101010101010101101
101000000000000000000000000000000000000000000000000000000101
100000000000000000000000000000000000000000000000000000000001
100000000000000000000000000000000000000000000000000000000001
111111111111111111111111111111111111111111111111111111111111
