111111111111111111111111111111111111111111111111111111111111
100000000000000001111100000000000000000000000000000111000001
100000000000000001111100000000011111111000000000000111000001
100000111111100001111100000000011111111000011111101111000001
100000111111100001111100000000011111111000011111101111000001
100000111111100000000000000000000000000000011111100000000001
100000111111100000000000000000000000000000000000000000000001
100000000000000000000000000111100000000000000000000000000001
100000000000000000000000000111100000000000001111100000000001
100000000000000000000000000111100000000000001111100000000001
100000111111111111110000000000000000000000001111100000000001
100000111111111111110000000000000000000000000000000000000001
100000111111111111110000000000000000000000000000000000000001
100000000000000000000000000000000000000000001111100000000001
100000000000000000000000000111100000000000001111100000000001
100000000000000000000000000111100000000000001111100000000001
100000000000000000000000000111100000000000000000000000000001
100000111111100000000000000000000000000000000000000000000001
100000111111100000000000000000000000000000000000000000000001
100000111111100001111100000000000000000000001111101111000001
100000111111100001111100000000011111111000001111101111000001
100000111111100001111100000000011111111000001111101111000001
100000000000000001111100000000011111111000000000001111000001
111111111111111111111111111111111111111111111111111111111111
